ss--=--ss......
.ss--=--ss.....
..ss--=--ss....
...ss--=--ss...
....ss--=--ss..
.....ss--=--ss.
......ss--=--ss
