.................
....WWWWWWWWW....
....W:::::::W....
....W:C:::C:W....
....W:::1:::W....
....W:::::::W....
....W:C:::C:W....
....W:::::::W....
....W:::p:::W....
....W:C:::C:W....
....W:::::::W....
....WWWWWWWWW....
.................